NO ./path_to_the_north_texture
SO ./path_to_the_south_texture
WE ./path_to_the_west_texture
EA ./path_to_the_east_texture
F 255,255,150
C 44,44,44
        1111111111111111111111111
        100000000011000D000000001
        1011100001110001000000001
        100010000000000D000000001111111111111111111111111111111111
111111111010100001110001000000001111000000000000000000000000000001
100000000010000001110111111111111111000000000000000000000000000001
111101111111110111000000100011111111000000000000000000000000000001
1111D1111111110111010100100011111111000000000000000000000000000001
1101010011010101110000001000D000D00D000000000000000000000000000001
100D00000D00000000000000100011111111000000000000000000000000000001
100111000100000011010100100011111111000000000000000000000000000001
11000001110101011111011000001111111100000000000000N000000000000001
11110111 1110101 1011110100011111111111111111111111111111111111111
11111111 1111111 111111111111