NO ./path_to_the_north_texture
SO ./path_to_the_south_texture
WE ./path_to_the_west_texture
EA ./path_to_the_east_texture
F 255,255,150
C 44,44,44
        1111111111111111111111111
        100000000011000D000000001
        10110000011100010000N0001
        100100000000000D000000001
111111111011000001110001000000001
100000000011000001110111111111111
11110111111111011100000010001
1111D111111111011101010010001
11010100110101011100000010001
100D00000D0000000000000010001
10011100010000001101010010001
1100000111010101111101100000111
11110111 1110101 101111010001
11111111 1111111 111111111111