NO          ./path_to_the_north_texture er

SO ./path_to_the_south_texture

WE     ./path_to_the_west_texture

EA       ./path_to_the_east_texture

F 240,248,255
C 176,196,222

11111111111111111111111111111
1000000000000000000000001
1000000000000000000000001
1000000000000000000000001
1000000000000000000000001
1000000000000000000000001
1000000000000000000000001
1000000000000000000000001
1000000000000000000000001
1000000000000000000000001
1000000000000000000000001
1000000000000000000000001
1000000000000E0000000000111111111
100000000000000000000000000000001
100000000000000000000000011111111
1111111111111111111111111