NO  ../textures/Brickwall2.xpm
SO    ../textures/Brickwall3.xpm
WE    ../textures/Brickwall4.xpm
EA ../textures/Stonewall.xpm



F 240,255,255
C 106,196,244
11111111111111111111111111111
1 11111111000000000000001
1111000001000011100000001
1000000000000000001000001
1000111111000000001000001
1000000000000000001000001
1000100100000000001000001
1000000000000000001111101
1100000000000000000000011
1000000100001000000100001
1000000000000000000000001
1100000000000000000010001
1000000000001000000000001
100000000000S000000000001
1000000000000000000000111
1111111111111111111111111